790000000000000000000000000000000000000000000000000000000079
ik00000000000000000000000000000000000000000000000000000000ik
ik00000000000000000000000000000000000000000000000000000000ik
ik00000000000000000000000000000000000000000000000000000000ik
ik00000000000000000000000000000000000000000000000000000000ik
ik0zAB00000000000Y0Y0Y000000000000000000000000000000000000ik
ik000000000000000YYYYY000000000000000000000000000000000000ik
ik000000000000000Y000Y000000000000000000000000000000000000ik
ik0000000000000000000Y000000000000000000000000000000000000ik
ik0000000000000000000Y000000000000000000000000000000000000ik
ik000000000000000Y000Y00000000000000YYYY000000000000000000ik
ik000000000000000Y000000000000000D0H000Y0000000000000zAB00ik
ik122222222222223Y00000000000000000K000Y000000000000000000ik
iknooooooooooooopYYYYYFFFFFFFFFFFFGM000YEFFFFFFFFFFFFFFFFGik
iw88888888888888888888888888888888888888888888888888888888yk
ijjjjjjjjjjjjjjZjjjjjjjjjjjjjjjjjjjjjjjjjjjjjjjjjjjjjjjjjjjk
ijZjjjjjZjjjjjjjjjjjjjjjjjjjjZjjjjZjjjZjZjjjZjjjZjjjZjjjjZjk
iZZjjjjjjjjjjjjjjjjjjjjjZjjjjjjjZjjjjjZjjjjjjjjjjjjjjjjjjjjk
ijjjjjjjjjjjjjjjZjjjjjjjjjjjjjjjjjjjjjjjjjjjjjjZjjjjjjZjjjjk
tuuuuuuuuuuuuuuuuuuuuuuuuuuuuuuuuuuuuuuuuuuuuuuuuuuuuuuuuuuv
